1111111111
1300001001
1100001001
1010001001
1001001001
1001000101
1001000001
1001111101
1001000101
1001000101
1000011101
1000010001
1000010001
1$00000001
1111111111