
			

			------- FELICIDADES, ENCONTRASTRE EL TESORO!! -------


                                                                                                          
                                    ████████████████████████████████████████████████████                  
                ████████████████████████████████████▓▓▓▓██▓▓▓▓▓▓▓▓▓▓▓▓▓▓▓▓▓▓▓▓▓▓██░░░░██████              
            ▓▓▓▓▓▓░░░░░░██████░░░░▒▒░░░░████████▓▓████▓▓██▓▓▓▓▓▓▓▓▓▓▓▓▓▓▓▓▓▓▓▓▓▓▓▓▓▓░░░░░░░░██            
          ██▒▒▒▒░░░░░░░░░░░░████░░░░░░░░░░██████████▓▓▓▓▓▓▓▓▓▓▓▓▓▓▓▓▓▓▓▓▓▓▓▓▓▓▓▓▓▓▓▓██░░░░░░░░██          
        ▓▓▒▒▒▒░░░░░░░░░░░░░░░░██▓▓░░░░░░░░░░████████████████████████████████████████████░░░░░░░░▓▓        
        ██▒▒░░░░░░░░░░░░░░░░░░░░██░░░░░░░░░░████████████████████▓▓▓▓▓▓▓▓▓▓▓▓▓▓▓▓▓▓▓▓██████░░░░░░████      
      ▓▓▒▒▒▒░░░░░░░░░░░░░░░░░░░░██▓▓▒▒░░░░░░░░██████████▓▓▓▓▓▓████████▓▓▓▓▓▓▓▓▓▓▓▓▓▓▓▓▓▓██░░░░░░░░██▓▓    
    ██▒▒▒▒░░░░░░▒▒████░░░░░░░░░░░░██▒▒▒▒░░░░░░████████████▓▓▓▓▓▓▓▓▓▓▓▓▓▓▓▓▓▓▓▓▓▓▓▓▓▓▓▓▓▓▓▓▒▒▒▒░░░░░░██    
    ██▒▒▒▒░░░░████▓▓████░░░░░░░░░░░░██▒▒░░░░░░░░████▓▓██▓▓████████████▓▓▓▓▓▓▓▓▓▓▓▓▓▓▓▓▓▓▓▓██▒▒░░░░░░██    
    ░░▒▒░░░░██████▓▓▓▓▓▓██░░░░░░░░░░██▒▒▒▒░░░░░░██▓▓▓▓▓▓▓▓▓▓▓▓▓▓▓▓▓▓▓▓▓▓▓▓▓▓▓▓▓▓▓▓▓▓▓▓▓▓▓▓██▒▒░░░░  ████  
  ▓▓▒▒▒▒░░░░████▓▓▓▓▓▓▓▓██░░░░░░░░░░░░██▒▒░░░░░░████████▓▓▓▓▓▓▓▓▓▓▓▓▓▓▓▓▓▓▓▓▓▓▓▓▓▓▓▓▓▓▓▓▓▓▓▓▒▒▒▒░░░░░░██  
  ██▒▒░░░░░░██████▓▓▓▓▓▓▓▓▓▓░░░░░░░░░░██▒▒░░░░░░████▓▓▓▓▓▓▓▓▓▓▓▓▓▓▓▓▓▓▓▓▓▓▓▓▓▓▓▓▓▓▓▓▓▓▓▓▓▓▓▓▓▓▒▒░░░░░░██  
  ██▒▒░░░░▓▓████▓▓▓▓▓▓▓▓▓▓██▓▓░░░░░░░░██▒▒░░░░░░██████████████████████████████████████████▓▓██▒▒░░░░░░██  
  ██▒▒░░░░██████████▓▓▓▓▓▓▓▓██░░░░░░░░██▒▒░░░░░░██████████████████████▓▓▓▓▓▓▓▓▓▓▓▓▓▓▓▓▓▓██████▒▒░░░░░░████
  ██▒▒░░░░██████▓▓▓▓██████████░░░░░░░░██▒▒░░░░░░████▓▓▓▓▓▓▓▓▓▓▓▓▓▓▓▓██████▓▓▓▓▓▓▓▓▓▓▓▓▓▓▓▓▓▓██▒▒░░░░░░░░██
  ██▒▒░░░░████▓▓▓▓▓▓▓▓▓▓▓▓████░░░░░░░░██▒▒▒▒▒▒░░████████████████▓▓▓▓▓▓▓▓▓▓▓▓▓▓▓▓▓▓▓▓▓▓▓▓▓▓▓▓██▒▒░░░░░░░░██
  ██▒▒▒▒░░██████▓▓▓▓▓▓▓▓▓▓████░░░░░░░░██▒▒▒▒▒▒▒▒████▓▓▓▓██████▓▓▓▓▓▓▓▓██▓▓▓▓▓▓▓▓▓▓▓▓▓▓▓▓▓▓▓▓██▒▒░░░░░░░░██
  ██▒▒▒▒▒▒██████▓▓▓▓▓▓▓▓▓▓████░░░░░░░░██▒▒▒▒▒▒░░██████████▓▓████████████▓▓▓▓▓▓▓▓▓▓▓▓▓▓████████████████████
  ██████▓▓████████████████████▓▓██▓▓▓▓████████▓▓██████████████████████████████████████░░░░░░░░░░░░░░░░████
  ██░░░░░░░░░░░░░░░░░░░░░░░░░░░░░░░░░░██▒▒▒▒░░░░░░░░░░░░░░░░░░██▒▒▒▒▒▒▒▒▒▒░░░░░░░░░░████▒▒░░░░░░░░░░░░░░██
  ██▒▒░░░░░░░░░░░░░░░░░░░░░░░░░░░░░░░░██▒▒▒▒░░░░░░░░░░░░░░░░░░██▒▒▒▒░░░░▒▒░░░░░░░░░░░░██▒▒▒▒░░░░░░░░░░░░██
  ██▒▒░░░░░░░░░░░░░░░░░░▒▒▒▒▒▒▒▒░░░░░░██▒▒▒▒▒▒░░▒▒░░░░░░░░░░░░██▒▒▒▒░░░░░░██████░░░░░░██▒▒░░░░░░░░░░░░████
  ██▒▒▒▒▒▒▒▒▒▒▒▒▒▒▒▒▒▒▒▒▒▒▒▒▒▒▒▒▒▒░░░░██░░░░▒▒▒▒░░░░░░░░░░░░░░██▒▒▒▒░░░░██▓▓▓▓▓▓██░░░░██▒▒░░░░░░░░░░░░██  
  ██████████████████████████████████████████████████████████████▒▒▒▒░░░░██▓▓▓▓████░░░░██████████████████  
  ██▒▒▒▒▒▒████▓▓▓▓▓▓▓▓▓▓▓▓▓▓██▒▒░░▒▒▒▒░░██▒▒▒▒▒▒░░██████████▓▓██▒▒▒▒░░░░░░██▓▓██░░░░░░██████████░░░░░░██  
  ██▒▒▒▒▒▒████▓▓▓▓▓▓▓▓▓▓▓▓▓▓██░░░░░░░░░░██▒▒▒▒░░░░████████▓▓▓▓██▒▒▒▒░░░░░░██▓▓██░░░░░░██████████░░░░░░██  
  ██▒▒▒▒░░██▓▓▓▓▓▓▓▓▓▓▓▓▓▓▓▓██░░░░░░░░░░██▒▒░░░░░░████████▓▓▓▓██▒▒▒▒░░░░░░██▓▓██░░░░░░██████▓▓██░░░░░░██  
  ██▒▒▒▒░░██▓▓▓▓▓▓▓▓▓▓▓▓▓▓▓▓██░░░░░░░░░░██▒▒░░░░░░██████▓▓▓▓▓▓██▒▒▒▒░░░░░░██████░░░░░░████▓▓▓▓██░░░░░░██  
  ██▒▒▒▒░░████▓▓▓▓▓▓▓▓▓▓▓▓▓▓██░░░░░░░░░░██▒▒░░░░░░██████████▓▓██▒▒▒▒░░░░░░░░░░░░░░░░░░████▓▓▓▓██░░░░░░██  
  ██▒▒░░░░████████████████████░░░░░░░░░░██▒▒░░░░░░████████████████▒▒▒▒░░░░░░░░░░░░░░████████████░░░░░░██  
  ██▒▒░░░░██████▓▓▓▓▓▓▓▓▓▓▓▓██░░░░░░░░░░██▒▒░░░░░░██████████████████▒▒▒▒▒▒░░░░░░░░████▓▓▓▓▓▓▓▓██░░░░░░██  
  ██▒▒░░░░██████▓▓▓▓▓▓▓▓▓▓▓▓██░░░░░░░░░░██▒▒░░░░░░████▓▓▓▓▓▓▓▓████████░░▒▒░░░░██▓▓▓▓▓▓▓▓▓▓▓▓▓▓██░░░░░░██  
  ██▒▒░░░░██████▓▓▓▓▓▓▓▓▓▓▓▓██░░░░░░░░░░██▒▒░░░░░░████████████▓▓▓▓████▓▓██████▓▓▓▓▓▓▓▓▓▓▓▓▓▓▓▓██░░░░░░██  
  ██▒▒░░░░████▓▓██▓▓▓▓▓▓▓▓▓▓██░░░░░░░░░░██▒▒░░░░░░████▓▓▓▓▓▓▓▓▓▓▓▓████████▓▓▓▓▓▓▓▓▓▓▓▓▓▓▓▓▓▓▓▓██░░░░░░██  
  ██▒▒░░░░████████▓▓▓▓▓▓▓▓▓▓██░░░░░░░░░░██▒▒░░░░░░██████████████▓▓▓▓▓▓▓▓▓▓▓▓▓▓▓▓████████████████░░░░░░██  
  ██▒▒░░░░████████████████████░░░░░░░░░░██▒▒░░░░░░████████████████████████████████▓▓▓▓▓▓▓▓▓▓▓▓██░░░░░░██  
  ██▒▒░░░░██████████▓▓▓▓▓▓▓▓██░░░░░░░░░░██▒▒░░░░░░██████████████▓▓▓▓▓▓▓▓▓▓▓▓▓▓▓▓▓▓▓▓▓▓▓▓▓▓▓▓▓▓██░░░░░░██  
  ██▒▒░░░░██████▓▓▓▓▓▓▓▓▓▓▓▓██░░░░░░░░░░██▒▒░░░░░░████████████████▓▓▓▓▓▓▓▓▓▓▓▓▓▓▓▓▓▓▓▓▓▓▓▓▓▓▓▓██░░░░░░██  
  ██▒▒░░░░████████▓▓▓▓▓▓▓▓▓▓██░░░░░░░░░░██▒▒░░░░░░████████▓▓▓▓▓▓▓▓▓▓▓▓▓▓▓▓▓▓▓▓▓▓▓▓▓▓▓▓▓▓▓▓▓▓▓▓██░░░░░░██  
  ██▒▒░░░░████████████████████░░░░░░░░░░██▒▒░░░░░░██████████████████████████████████████████████▒▒░░░░██  
  ██▒▒░░░░░░░░░░░░░░░░░░░░░░░░░░░░░░░░░░██▒▒░░░░░░░░░░░░░░░░░░░░░░░░░░░░░░░░░░░░░░░░░░░░░░░░░░▒▒▒▒░░░░██  
  ██▒▒▒▒▒▒▒▒▒▒▒▒▒▒▒▒░░░░░░░░░░░░░░░░░░░░██▒▒░░░░░░░░░░░░░░░░░░░░░░░░░░░░░░░░░░░░░░░░░░░░░░░░░░▒▒▒▒░░░░██  
  ██▒▒▒▒▒▒▒▒▒▒▒▒▒▒▒▒▒▒▒▒▒▒▒▒▒▒▒▒▒▒▒▒▒▒▒▒██▒▒▒▒▒▒▒▒▒▒▒▒▒▒▒▒▒▒▒▒▒▒▒▒▒▒▒▒▒▒▒▒▒▒▒▒▒▒▒▒▒▒▒▒▒▒▒▒▒▒▒▒▒▒▒▒▒▒░░██  